11111111111111111111111
1P0C00010000000000001E1
1110000100000000C0001C1
1110000C00000C00C00C001
1110000100000000C000001
11111111111111111111111