11111111111111
10000001000001
11000001000001
101001C0000C01
1P100100000001
10100100000001
1010010000C001
1000010000E011
11111111111111