1111011011111
1P00000100001
1100000100001
1010010000001
10000100C0E01
1C00010000001
1111111101110